XXXXXXXXXEXXXXX
X X X   X     X
X X X X X XXX X
X X   X   X   X
X XXXXXXXXX XXX
X   X     X X X
X X XXXXX X X X
X X       X   X
X XXXXX XXXXX X
X X   X X     X
X X X XXX XXXXX
X X X X   X   X
X X X X XXX X X
X   X       XSX
XXXXXXXXXXXXXXX