XXXXZZYZYY
Y     YE Y
Y  X  Y  Y
YXXX  YY Y
Y      X Y
Y    X   Y
YYYY XXXXY
YS X    XY
Y    XX  Y
YYYYYYYYYY
