XXXXXZZZX 
  ZZ Z ZZX
   ZZZ  ZZ
ZZZZ     X
ZXXZ     X
ZZXZZZZ  X
 ZZZXXXZ X
X XZ   ZZX
 XXZ  ZZZ 
   ZZZZ   
